併	倂
俞	兪
俱	倶
值	値
偷	偸
偽	僞
册	冊
删	刪
即	卽
唧	喞
喻	喩
嚏	嚔
塈	墍
填	塡
妍	姸
姗	姍
媮	婾
媯	嬀
尚	尙
屏	屛
巔	巓
帡	帲
并	幷
廄	廏
惪	悳
慎	愼
教	敎
既	旣
暨	曁
查	査
栅	柵
概	槪
榆	楡
槙	槇
污	汚
清	淸
溈	潙
溉	漑
為	爲
瓶	甁
真	眞
研	硏
箳	簈
緒	緖
胼	腁
蒍	蔿
訮	詽
豜	豣
軿	輧
迸	逬
邢	郉
郎	郞
郷	鄕
鄉	鄕
鈃	銒
鎮	鎭
青	靑
顛	顚
飲	飮
餅	餠
駢	騈
鷏	鷆
