厘	釐
只	衹
咒	呪
妒	妬
摀	捂
暱	昵
梔	栀
棲	栖
歎	嘆
沉	沈
溼	濕
煅	鍛
煉	鍊
狸	貍
糉	粽
絃	弦
纔	才
脣	唇
蒞	莅
詛	咀
譁	嘩
贗	贋
跡	迹
鈈	鈽
鉤	鈎
鍼	針
鐮	鎌
鑑	鑒
隸	隷
雞	鷄
霉	黴
餚	肴
鱷	鰐
齶	腭
