鈈	鈽
纔	才
沉	沈
脣	唇
鵰	雕
妒	妬
煅	鍛
鱷	鰐
齶	腭
槓	杠
鉤	鈎
袞	衮
滾	滚
雞	鷄
跡	迹
厘	釐
蒞	莅
狸	貍
煉	鍊
霉	黴
暱	昵
嫋	裊
棲	栖
溼	濕
歎	嘆
污	汙
勛	勳
贗	贋
餚	肴
湧	涌
皁	皂
唕	唣
鍼	針
梔	栀
只	衹
咒	呪
糉	粽
